#######
#.0.1.#
#.....#
#.#.#.#
#.....#
#######