#######
#.#...#
##....#
#.#.#.#
#.....#
#######