#######
#..1..#
#.....#
#.#.#.#
#.....#
#######